206
0 11 0 96 64 160 0 0 0 0
1 19 16 252 44 96 0 0 0 0
2 11 0 352 448 32 0 0 0 0
3 11 64 736 960 32 0 0 0 0
4 11 256 704 64 32 0 0 0 0
5 11 386 640 64 32 0 0 0 0
6 21 318 704 64 64 0 0 0 0
7 22 698 700 64 36 0 0 0 0
8 22 837 700 64 36 0 0 0 0
9 22 955 700 64 36 0 0 0 0
10 11 450 608 64 32 0 0 0 0
11 11 450 320 960 32 0 0 0 0
12 11 514 546 960 32 0 0 0 0
13 11 1026 800 320 32 0 0 0 0
14 11 1442 352 32 32 0 0 0 0
15 11 1474 98 32 352 0 0 0 0
16 21 1342 446 96 96 0 0 0 0
17 21 1310 544 64 64 0 0 0 0
18 11 1474 408 32 96 0 0 0 0
19 11 1346 706 64 128 0 0 0 0
20 11 1474 480 128 96 0 0 0 0
21 11 1440 674 224 32 0 0 0 0
22 11 1570 866 32 352 0 0 0 0
23 11 1600 928 64 32 0 0 0 0
24 21 1632 926 64 64 0 0 0 0
25 21 1663 833 64 64 0 0 0 0
26 11 1600 994 512 32 0 0 0 0
27 11 1666 610 384 32 0 0 0 0
28 11 2240 608 64 32 0 0 0 0
29 11 1730 768 64 32 0 0 0 0
30 11 1858 768 64 32 0 0 0 0
31 11 1986 736 128 32 0 0 0 0
32 11 2174 736 128 32 0 0 0 0
33 11 2108 928 64 32 0 0 0 0
34 11 2498 608 192 32 0 0 0 0
35 11 2754 544 32 32 0 0 0 0
36 11 2818 608 192 32 0 0 0 0
37 11 2690 674 64 32 0 0 0 0
38 11 2368 738 640 32 0 0 0 0
39 11 3074 684 32 32 0 0 0 0
40 19 3086 892 44 96 0 0 0 0
41 11 3200 1058 64 32 0 0 0 0
42 11 3266 994 128 32 0 0 0 0
43 11 3458 992 192 32 0 0 0 0
44 11 3648 1058 64 32 0 0 0 0
45 11 3714 1122 64 32 0 0 0 0
46 11 3810 994 160 32 0 0 0 0
47 11 3778 1026 32 128 0 0 0 0
48 11 4002 1058 32 32 0 0 0 0
49 11 4034 866 32 352 0 0 0 0
50 21 3840 1216 160 160 0 0 0 0
51 11 4034 1250 32 128 0 0 0 0
52 11 3938 1440 128 32 0 0 0 0
53 11 3586 1568 480 32 0 0 0 0
54 21 3806 1568 128 128 0 0 0 0
55 21 3742 1374 128 128 0 0 0 0
56 11 3618 1346 32 128 0 0 0 0
57 11 3650 1376 256 32 0 0 0 0
58 19 3600 1470 44 96 0 0 0 0
59 12 3990 1450 16 32 0 0 0 0
60 30 3990 1450 32 16 3990 1450 4022 1570
61 12 3738 1436 16 32 0 0 0 0
62 30 3738 1436 16 16 3738 1436 3788 1570
63 12 3860 1268 16 32 0 0 0 0
64 30 3860 1268 16 16 3860 1268 3888 1374
65 9 3650 1314 44 64 3650 1314 3809 1380
66 3 3666 1268 32 32 3666 1268 3898 1380
67 15 434 1376 16 32 0 0 0 0
68 12 3990 886 16 32 0 0 0 0
69 30 3990 886 16 16 3990 886 4028 1114
70 12 3872 886 16 32 0 0 0 0
71 30 3872 886 16 16 3872 886 4028 1114
72 12 3738 886 16 32 0 0 0 0
73 30 3738 886 16 16 3738 886 3774 1122
74 12 3610 886 16 32 0 0 0 0
75 30 3610 886 16 16 3610 886 3642 992
76 9 3712 1056 44 64 3712 1056 3774 1120
77 3 3666 890 32 32 3666 890 3966 992
78 15 3776 994 64 64 0 0 0 0
79 29 3778 994 28 28 3666 890 3966 992
80 12 3480 888 16 32 0 0 0 0
81 30 3480 888 16 16 3480 888 3516 992
80 12 3480 888 16 32 0 0 0 0
83 32 3898 880 30 30 3898 880 3356 992
84 12 3224 876 16 32 0 0 0 0
85 30 3224 876 16 16 3224 876 3264 1056
86 9 3326 928 44 64 3326 928 3390 992
87 17 3132 992 3266 992 0 0 0 0
88 12 2966 876 16 32 0 0 0 0
89 30 2966 876 16 16 2966 876 3008 992
90 12 2844 876 16 32 0 0 0 0
91 30 2844 876 16 16 2844 876 2880 992
92 12 2718 876 16 32 0 0 0 0
93 30 2718 876 16 16 2718 876 2750 992
94 12 2590 876 16 32 0 0 0 0
95 30 2590 876 16 16 2590 876 2622 992
96 12 2460 876 16 32 0 0 0 0
97 25 2460 876 16 16 2460 876 2490 992
98 12 2334 876 16 32 0 0 0 0
99 30 2334 876 16 16 2334 876 2366 992
100 12 2212 876 16 32 0 0 0 0
101 30 2212 876 16 16 2212 876 2270 992
102 12 2082 930 16 32 0 0 0 0
103 30 2082 930 16 16 2082 930 2110 992
104 3 3712 1056 32 32 3712 1056 2110 992
105 12 1948 896 16 32 0 0 0 0
106 30 1948 896 16 16 1948 896 1986 992
105 12 1948 896 16 32 0 0 0 0
108 30 1824 958 16 16 1824 958 1844 992
109 12 1688 880 16 32 0 0 0 0
110 30 1688 880 16 16 1688 880 1726 994
111 6 2282 880 720 112 2282 880 3002 992
112 6 2282 880 720 112 2282 880 3002 992
113 6 2282 880 720 112 2282 880 3002 992
114 6 2282 880 720 112 2282 880 3002 992
115 12 1690 692 16 32 0 0 0 0
116 30 1690 692 16 16 1690 692 1706 784
117 12 1940 674 16 32 0 0 0 0
116 30 1690 692 16 16 1690 692 1706 784
119 6 1725 670 577 118 2302 778 1725 670
120 6 1725 670 577 118 2302 778 1725 670
121 6 1725 670 577 118 2302 778 1725 670
122 6 1725 670 577 118 2302 778 1725 670
123 17 2044 608 2240 608 0 0 0 0
124 17 2300 608 2498 608 0 0 0 0
125 12 2254 682 16 32 0 0 0 0
126 30 2254 682 16 16 2254 682 2492 738
127 9 2273 929 44 64 2273 929 2369 993
128 12 2290 676 16 32 0 0 0 0
129 30 2290 676 16 16 2290 676 2876 738
130 9 2816 672 44 64 2816 672 2910 608
131 12 2710 518 16 32 0 0 0 0
132 30 2710 518 16 16 2710 518 2748 672
133 12 2584 508 16 32 0 0 0 0
134 27 2584 508 32 32 2584 508 2622 608
135 12 2328 534 16 32 0 0 0 0
136 30 2328 534 16 16 2328 534 2364 994
137 12 2072 534 16 32 0 0 0 0
138 30 2072 534 16 16 2072 534 2108 738
139 6 1660 502 386 106 1660 502 2046 608
140 6 1660 502 577 118 1660 502 2046 608
141 6 1660 502 577 118 1660 502 2046 608
142 6 2046 608 577 118 1660 502 2046 608
143 12 1820 524 16 32 0 0 0 0
144 30 1820 524 16 16 1820 524 1854 608
145 15 1408 672 16 16 0 0 0 0
146 12 1300 688 16 32 0 0 0 0
144 30 1820 524 16 16 1820 524 1854 608
148 12 1172 688 16 32 0 0 0 0
149 30 1172 688 16 16 1172 688 1214 798
150 12 1040 688 16 32 0 0 0 0
151 30 1040 688 16 16 1040 688 1086 798
152 12 918 688 16 32 0 0 0 0
153 30 918 688 16 16 918 688 960 738
154 12 786 688 16 32 0 0 0 0
155 30 786 688 16 16 786 688 830 738
156 12 658 688 16 32 0 0 0 0
157 30 658 688 16 16 658 688 702 738
158 5 414 702 28 28 658 688 702 738
159 12 542 648 16 32 0 0 0 0
160 30 542 648 16 16 542 648 574 738
161 12 542 648 16 16 0 0 0 0
162 30 274 580 16 16 274 580 316 708
163 5 62 574 28 28 62 574 576 738
164 4 480 546 32 64 480 546 480 546
165 4 606 484 32 64 606 484 606 610
166 5 480 546 32 64 62 574 576 738
167 12 1438 228 16 32 0 0 0 0
168 30 274 580 16 16 1438 228 1468 350
169 12 1304 228 16 32 0 0 0 0
170 30 1304 228 16 16 1304 228 1342 324
171 12 1174 228 16 32 0 0 0 0
172 30 1174 228 16 16 1174 228 1342 324
173 12 1044 228 16 32 0 0 0 0
174 30 1044 228 16 16 1044 228 1088 324
175 12 912 228 16 32 0 0 0 0
176 34 912 228 16 16 912 228 958 324
177 12 660 228 16 32 0 0 0 0
178 30 660 228 16 16 660 228 702 324
179 6 574 174 828 150 574 174 1402 324
180 6 574 174 828 150 574 174 1402 324
181 6 574 174 828 150 574 174 1402 324
182 6 574 174 828 150 574 174 1402 324
183 6 574 174 828 150 574 174 1402 324
184 6 574 174 828 150 574 174 1402 324
185 12 508 228 16 32 0 0 0 0
186 30 508 228 16 16 508 228 542 324
187 12 406 228 16 32 0 0 0 0
188 30 406 228 16 16 406 228 444 356
189 11 3010 480 32 352 0 0 0 0
190 11 2176 994 960 32 0 0 0 0
191 11 3586 1250 32 96 0 0 0 0
192 15 1408 674 32 32 0 0 0 0
193 15 2786 544 32 32 0 0 0 0
194 15 3778 994 32 32 0 0 0 0
195 15 4034 1378 32 32 0 0 0 0
196 15 4034 1410 32 32 0 0 0 0
197 11 4066 1378 32 64 0 0 0 0
198 11 4066 1282 32 64 0 0 0 0
199 11 4034 1476 32 96 0 0 0 0
200 1 199 260 65 64 199 260 0 0
201 33 2786 544 32 32 0 0 0 0
202 33 1408 674 32 32 0 0 0 0
203 39 1780 810 659 20 1780 810 2439 830
204 39 3112 1152 396 30 3112 1152 3508 1180
205 19 1546 575 44 96 0 0 0 0
