161
0 11 33 480 32 320 0 0 0 0
1 11 65 768 64 32 0 0 0 0
2 11 162 768 32 32 0 0 0 0
3 11 258 642 64 32 0 0 0 0
4 11 450 642 64 32 0 0 0 0
5 11 323 768 320 32 0 0 0 0
6 11 707 768 64 32 0 0 0 0
7 11 898 768 64 32 0 0 0 0
8 11 962 802 128 32 0 0 0 0
9 11 834 705 64 32 0 0 0 0
10 11 961 671 64 32 0 0 0 0
11 11 1090 640 64 32 0 0 0 0
12 11 1218 770 128 32 0 0 0 0
13 11 1346 738 64 32 0 0 0 0
14 11 1410 674 64 32 0 0 0 0
15 11 1506 481 32 128 0 0 0 0
16 11 1474 707 1536 32 0 0 0 0
17 11 1603 515 64 32 0 0 0 0
18 11 2818 579 128 32 0 0 0 0
19 11 3009 482 32 224 0 0 0 0
20 11 34 867 32 352 0 0 0 0
21 11 66 1090 64 32 0 0 0 0
22 11 129 1153 128 32 0 0 0 0
23 11 259 1186 1120 32 0 0 0 0
24 11 194 1026 192 32 0 0 0 0
25 11 578 1090 64 32 0 0 0 0
26 11 834 1090 64 32 0 0 0 0
27 11 2561 320 64 32 0 0 0 0
28 11 3392 320 192 32 0 0 0 0
29 11 3648 320 256 32 0 0 0 0
30 11 3905 289 64 32 0 0 0 0
31 11 3970 258 1664 32 0 0 0 0
32 11 4032 128 128 32 0 0 0 0
33 11 5696 258 64 32 0 0 0 0
34 11 5825 258 64 32 0 0 0 0
35 11 5952 258 704 32 0 0 0 0
36 11 6529 133 64 32 0 0 0 0
37 11 6626 289 96 32 0 0 0 0
38 11 6720 320 32 32 0 0 0 0
39 11 6752 652 32 32 0 0 0 0
40 11 6656 416 512 32 0 0 0 0
41 21 128 768 128 128 0 0 0 0
42 20 128 768 64 64 0 0 0 0
43 20 160 864 160 160 0 0 0 0
44 21 768 769 64 64 0 0 0 0
45 20 1152 640 128 128 0 0 0 0
46 21 2688 705 128 128 0 0 0 0
47 11 2657 320 672 32 0 0 0 0
48 11 6752 353 32 32 0 0 0 0
49 20 2720 480 96 96 0 0 0 0
50 20 2623 319 128 128 0 0 0 0
51 19 1501 607 44 96 0 0 0 0
52 19 4061 157 44 96 0 0 0 0
53 12 310 578 16 32 0 0 0 0
54 30 310 578 16 32 310 578 320 642
55 12 438 708 16 32 0 0 0 0
56 30 438 708 16 32 438 708 464 770
57 12 566 708 16 32 0 0 0 0
58 30 566 708 16 32 566 708 587 770
59 12 692 708 16 32 0 0 0 0
60 30 692 708 16 32 692 708 720 770
61 12 692 708 16 32 0 0 0 0
62 30 692 708 16 32 692 708 720 770
63 12 836 644 16 32 0 0 0 0
64 30 836 644 16 32 836 644 863 705
65 12 947 742 16 32 0 0 0 0
66 30 947 742 16 32 947 742 960 770
67 12 1077 742 16 32 0 0 0 0
68 30 1077 742 16 32 1077 742 1094 770
69 12 1205 708 16 32 0 0 0 0
70 23 1205 708 16 32 1205 708 1228 796
71 12 1333 710 16 32 0 0 0 0
72 30 1333 710 16 32 1333 710 1349 737
73 12 1461 614 16 32 0 0 0 0
74 30 1461 614 16 32 1461 614 1473 673
75 12 1592 582 16 32 0 0 0 0
76 30 1592 582 16 32 1592 582 1618 704
77 12 1734 645 16 32 0 0 0 0
78 30 1734 645 16 32 1734 645 1768 704
79 12 2629 516 16 32 0 0 0 0
80 30 2629 516 16 32 2629 516 2688 704
81 12 2757 646 16 32 0 0 0 0
82 30 2757 646 16 32 2757 646 2797 704
83 12 2885 646 16 32 0 0 0 0
84 30 2885 646 16 32 2885 646 2931 704
85 12 311 965 16 32 0 0 0 0
86 30 311 965 16 32 311 965 345 1025
87 12 184 1094 16 32 0 0 0 0
88 30 184 1094 16 32 184 1094 222 1153
89 12 440 1124 16 32 0 0 0 0
90 30 440 1124 16 32 440 1124 480 1186
91 12 568 1124 16 32 0 0 0 0
92 30 568 1124 16 32 568 1124 611 1186
93 12 696 1124 16 32 0 0 0 0
94 30 696 1124 16 32 696 1124 737 1186
95 12 824 1124 16 32 0 0 0 0
96 30 824 1124 16 32 824 1124 878 1186
97 12 949 1124 16 32 0 0 0 0
98 30 949 1124 16 32 949 1124 1104 1186
99 12 1078 1124 16 32 0 0 0 0
100 26 1078 1124 16 32 1078 1124 1121 1186
101 12 1206 1124 16 32 0 0 0 0
102 30 1206 1124 16 32 1206 1124 1255 1262
103 12 1334 1124 16 32 0 0 0 0
104 30 1334 1124 16 32 1334 1124 1137 1262
105 12 1463 1064 16 32 0 0 0 0
106 30 1463 1064 16 32 1463 1064 1500 1154
107 12 2759 261 16 32 0 0 0 0
108 30 2759 261 16 32 2759 261 2803 321
109 12 2870 169 16 32 0 0 0 0
110 27 2870 169 16 32 2870 169 2944 321
111 12 3125 169 16 32 0 0 0 0
112 30 3125 169 16 32 3125 169 3174 321
113 12 3894 196 16 32 0 0 0 0
114 30 3894 196 16 32 3894 196 3957 290
115 12 4021 196 16 32 0 0 0 0
116 30 4021 196 16 32 4021 196 4067 258
117 12 4150 196 16 32 0 0 0 0
118 30 4150 196 16 32 4150 196 4197 258
119 12 6581 196 16 32 0 0 0 0
120 30 6581 196 16 32 6581 196 6631 258
121 12 6837 295 16 32 0 0 0 0
122 30 6837 295 16 32 6837 295 6751 621
123 12 6965 295 16 32 0 0 0 0
124 30 6965 295 16 32 6965 295 7032 621
125 12 7092 295 16 32 0 0 0 0
126 30 7092 295 16 32 7092 295 7156 621
127 40 63 687 1403 321 337 984 337 984
128 40 63 687 1403 321 594 1051 594 1051
129 40 63 687 1403 321 853 1051 853 1051
130 5 258 118 1093 31 1300 1111 1300 1111
131 42 66 927 323 260 66 1028 66 1028
132 41 315 483 1153 347 543 518 543 518
133 41 315 483 1153 347 831 614 831 614
134 41 315 483 1153 347 956 551 956 551
135 41 315 483 1153 347 1036 776 1036 774
136 42 315 483 1153 347 715 707 715 707
137 42 315 483 1153 347 1285 707 1285 707
138 6 1600 515 1154 192 2679 551 1600 701
139 6 1600 515 1154 192 2184 598 1600 701
140 6 1600 515 1154 192 2487 633 1600 701
141 42 2359 482 605 226 2864 518 2864 518
142 41 2821 98 1044 226 3084 167 3084 167
143 41 2821 98 1044 226 3517 295 3517 295
144 41 2821 98 1044 226 3645 295 3645 295
145 4 3277 257 44 64 3277 257 3277 257
146 4 3790 257 44 64 3790 257 3277 257
147 41 4200 96 2285 159 4616 135 4616 135
148 41 4200 96 2285 159 4803 135 4803 135
149 41 4200 96 2285 159 5068 118 5068 118
150 41 4200 96 2285 159 5196 118 5196 118
151 41 4200 96 2285 159 5572 136 5572 136
152 42 4200 96 2285 159 5709 196 5709 196
153 42 4200 96 2285 159 5838 196 5838 196
154 6 4200 96 2285 159 6284 170 4200 257
155 4 4909 192 44 64 4909 192 4909 192
156 4 5419 192 44 64 5419 192 5419 192
157 4 6447 192 44 64 6447 192 6447 192
158 43 6701 337 487 130 6701 337 6701 342
159 43 7084 337 487 130 7084 337 7084 342
160 11 1343 1152 192 32 0 0 0 0
